1000 1000 9
3000000001100001000001000110100000000000011110000100000101010000001001010010000000000100000010010110
0000101100000100011001000000010100000000011000000100000001011110100101100001000000101010100000100100
0000000100000001111000001000010000000110000000000011011101110010001100000001000001000000000000100101
1000100000100010100000100101010111000010001000000100000000001010010000001100000000000100010000001000
0000010010000001000101001001000100010000110010010100000101000101110010101000000000100000000000000010
0000000100001010000000000000001100100011110111000000100010011001000000000000001111100101000010000000
0100010010000010000000000010100001011000001001100000100000010000010000010001001001000100000000000000
0000000100000001101100010101000000000000000010000101000100100100000001010000110000001000000010001010
0001000000101010010010000001100000110101000000000110000101010110100001010000000000000000000010000000
0000001100001000000000000001000000100100000010000000101000001000000000000110001100000000010110000100
0010000000010110000001010000000010010000010010001100000101110000011100010010001011000000011100001000
0100100110000100000001100010100010100000100000001000000001010000100100010000010000000110100000000000
0000000000000001000000000000100000001001001001000100000010001000110000000010010001100100111100000101
0000000010010000100100000000000010100000001000001000010000000110100010000101000100001000110000110000
0100001000010000000001000000000000010000000001010001000100000000100000001000000010000101110100000001
0010001000000000010001000110100100011000110010000000000000101000100001101110010000000001010000001100
1100000100100000000000000000000100000011100000101000001001000000000001100101000010011000000011000000
0100111010101000100101000010110001000010000000100000000000000001001001100001100000000110010010101010
0100010011010000000000000100001001001010000000111001100000000000000000110011000000000001000000001011
0000010000000101000100000000000001100011000000101000000000000000010000010001011010100000011010000001
0000000000001000000101011000000010001100101100000000000010000100000010000000010000100010000000010100
0000000000000000100000000000000010000101000000010000100000010001000000100101010000110010001010000000
0001000000000111010000010100000000100000101001000000000100001101110000100100000100000001010001100000
0000001000001000000000000101100100000101100000010000010010000000000001011000000110001000100010000000
0001010100100100010000011001100111101001001100000001000010000100100010001000000000100100000000000011
1100000100000000100010110010010001000000110000011011100100000110000001010000001101100000010000010001
1100000000100010000000000110100000100000101100011000100011000011000000000011001000001101110101000100
0100000010000111111101100100110001100110000010110001000011000101101010101000001010100000110000000000
0101000000011010001000000010000000000000010101000000100011000011000000000000000000000000000010000000
0100000000000000001000010000000000010000011000001000100011100100010100100101000001001000101000000000
0100010000001000000000000001000010010000100101000000010000001000000001000011010000100001000111010001
1000110000000110100100000000001000010000100000101001000101000000100000001000100001011000100000011010
1000000100000000000001100100000000000000100000100001000010111010101100000100000100010100000000001000
0111000000000101100100100000000000100100100000000011011000000110000000001000111000101000000010110010
1011000000100000000010000011000111001010000000010010000000000011000001000000000000000110010000000001
0100010110000001011010100000010000000000100101000000000010111000100100000000100001000011000100100110
0000101001101010100000000001000000011001000001010001000000000001000001100100000110100010000000000001
0001100000011000010111100010101110000101000000001100000110110001000001000000000110000000100000000000
0011000100000010000000000000000000110000001001000000010100100001011000110000100001011000000011010100
0100000010000010100000001010100010100001000110010000010100000000000100001010100011000010110101001010
0000000000001000000000000010000000000010100000111110010000000001010100110110000000000100010000000100
0101011000000111101011001101000000001001101000000001001000010101100011010101000000100000000000001000
0011000100000001000000000010010010110000000001100000010101100000110010111101100011001001000010000001
0100001000000110100000000101100001000010100011000011001000001010110000100000010011000100000000011001
0111100011000100000000011100110011000101001000000000010100000000110011000100000001011000000000000000
0001010001100000010100000000010011000001010110000100100000000000100000010010000010100100000000000001
0000000010100000000010001001001000000101000000000100000001100001100000100011001001000000000100010101
0001000101010000110100100010100000000010000011000100100010000000001000101000100011100000001010000000
1001000100111000100001001000001001101100001000000001001000100100000001000001100000010100001110000100
0010010000000000010000000000000000000011000100001001000110000000011101100101000001001000000000000000
0001000000000100000000000000000000110000010000000010001000001000000110000110000001100000000011101001
0001001010010000010111001000101000100011011010010000000010101000010001010000001010000000000000001001
0001000100000001100001110010100000001000001100010000001001000110000101011000010000010011000000110000
0000000000000010001000010010100100100100000101011101100111100010100000000100000010011001110011100110
0000011001000001000010000100001000000010011010100000000111101010000000000010000010011000001000010000
0000001111000100011011100000110000000000100010010000001011000011100000000000000000011000001010000011
0000000010011010000100100101000000000000100001000000000001000100100100000001010100101000000000110001
1010111000000000001010111010111100010000001001000000000000100000100000000100000001000010000000010000
1001000001100010101010001000101000000000011010000000001000100010001001000001000100000000001001000000
0001001000101000001011011001000010001111000000000110101010111000011000010110000000000000000000010100
1010000000100000000000000110100000000010000000100100001001000011000000000001100000010011100011000000
0110000000010011010000000000100110000000100000000110010000100100000000000000101001000001110010000100
0011010001000000000001000100011001010000111000000010000000100001001000001101000110000000010000000100
0000000011010110100110000110000100001000101000000010111010000010000011110101000000000000011100000100
1100100000001000000110000000000000100010000000001100101100011100000100000001000000100001001000000100
0000000000000001101000111000101100001010000001011000000010000010001100000001000110100100000000000000
0100010001000100010000011100100001000000000001110010000101000110000110010100000000010010001000000000
0000000000001100010001010000000000100000111000001001001000000000011010100000000000111100010001001000
0000000001000000011000010000000110100001000000011000011000011000001101100000110101000010000000010000
1100000011001000101010000000011110010000000000001010000000000100101000000000001000000000000001000011
1000000010100010101000000100100000000000001000000110000000100000010000110010100100000010100101110011
0100000001010010100000000100001001001001000000000000100000000000011010010011010000000000001010001000
1001011001000100000001010011010100000010010000011001010010010100000000100000000001000100110010010000
0110000000000011101000000000001000100010000011000001000000001001110100001011100001100010100000100100
1010001100000011010010011001000001000101010000101010000000010000001001101001100010000100100000000000
0000000001000100001110000010010000010100000000001000000010000011101000010000000001011000001001110010
1101010000000000001100000100010001100010101010101000000001000000011000000000100000000010000101010100
0000010010100010100110010001000000000000000000000000000100100100000001000000100000000101000100000100
1000100100010001000110100001001000100000000011000000000101010000100000010000000101000100011000010000
1100000000010011001010000001001000000001000000101111100010100010100001111100001000001010001001011000
0110000001001100000000000110011000000011100100000000100010100010010110110110000101000001010000000001
0100010000001000010000000000001110001010000000010110000001001010000110001001000000010010000100110000
1101111000001110000000011010010000001010100010010100100011101011001000010001000110110111001000000000
1001000000000000000001000111000000011011000000010110001100000100100000001010000011001000000001110010
1010100010100000000011000000000100000110100100001100000100100001000100000010000001010000000111000100
1000000010000101000000000100110000001110000001000100000000001001001100010000100000011000000000010100
0000011000000000101011100000000100111001110010100000010000100010000000000100010000011000100100010101
0010010101000010100010100001100000010000000000001100001010001000100000001000000101010000010000110011
0010000000100001000001010000001000001000000101000010001000101000000100110000101000010011010110011110
0000001100010000000000111001001000001001110100000010000000001010101000010011010101101000110110011100
0001000000000010000001001000000010010000000110000001000110011000011100001001000001000010111011000110
0000000100000001000101001101000110000000101001001001010000000000100010000111110000011000000000011001
0000001110010101000001101001100000000010000000000000100011101001100000001100001000000000100011000100
1000010000001001001000000000110000000010010010000001000000100000000100000100101101100101000000010101
0000000100000110001101010011101010000100000011000001000000100001000100100110010000111000010000100000
0000000000011101000000110001100100010000010000011000011110000000010000000111010011100000010100100010
0000100100110100000001001010001000000010100010000000100010001000000100100011001000101000100000100010
0010000000010011000010000111011101000100000000011010000000001010000000000000000000110110011010001000
1000000000000000000110001000000100011000101000100011000001010100000010000001010000100000100100000011
0001011001100010100000000000001000100000000001100010000001100000010001010000011100010100000000000004