1500 850 10
3000000000000000000000000000000000000000000000000000000000000000000000000000000000000000000000000000000000000000000000000000000000000000000000000000
0000000000000000000000000000000000000000000000000000001000110111001000000000001010000000000000000000000000000000000000000000000000000000000000000000
0000000000000000000000000000000000000000000000011111111111111111111111111111111001110111001000000000000000000000000000000000000000000000000000000000
0000000000000000000000000000000000000000111111101111111111111111111111111111111111111111010010000000000000000000000000000000000000000000000000000000
0000000000000000000000000000000000000001111111111011111111111111111111111111111111111111111110100001000000000000000000000000000000000000000000000000
0000000000000000000000000000000001111111111111111111111111111111111111111111111111111111111111111010001000000000000000000000000000000000000000000000
0000000000000000000000000000011001111111111111111111111111111111111111111111111111111111111110111111110111100000000000000000000000000000000000000000
0000000000000000000000000001011111111111111111111111111111111110111111111111110001110111111111111111111111110000000000000000000000000000000000000000
0000000000000000000000000000111111001111111111110000000000000100000111110011100001100010001111111111111111111111100000000000000000000000000000000000
0000000000000000000000000011111111110100000000011111111100000000000000000000010111111111000011001111110111111111100000000000000000000000000000000000
0000000000000000000000001111110110110000000000001111111111111111111111001111111111111111111110111101111111111111111110000000000000000000000000000000
0000000000000000000000111111111010000000000111111111111111111111111111111000000000000011111000000001111111110000111111110000000000000000000000000000
0000000000000000000001111111111000000000110111000000111100000011100000100000000000000000100000000000001011111100011111111100000000000000000000000000
0000000000000000000011111111000000011111111111110000000000000000000000000000000000000000000000000000000110011111000011111110000000000000000000000000
0000000000000000000111111110000000111111111111100000000000000000000000000000000000000000000000000000000001101111111000111111100000000000000000000000
0000000000000000001111111010011111111111111111111000000000000000000000000000000000000000000001110000000000111011111111111111110000000000000000000000
0000000000000000011111110100111111111111111111111100000000000000000000000000000000000000000000010000000000001100111111111111111000000000000000000000
0000000000000000111111111011111111011111111111111110000000000000000000000000000000000000000000011111110000000010011111111111111100000000000000000000
0000000000000001111111111110111100111111111111111100000000000000000000000000000000000000000000111111111100000000101111111111111111000000000000000000
0000000000000001111111111111110000000111111111111111000000000000000000000000000000000000000001111111111000000000110111111111111111000000000000000000
0000000000000011111101111011011000001111111111111110000000000000000000000000000000000000000000000111111111110000001001111111111111100000000000000000
0000000000000111111100111011111100001001111111111111011000000000000000000000000000000000000000011111111111110110001101111111111111100000000000000000
0000000000000111111111011101111000000011111111111111111000100000000000000000000000000000000000000001111111111111111100111111111111100000000000000000
0000000000000111111110111111111111111111111111100111000110000000000000000000000000000000000000000011111111111011110100111111111111110000000000000000
0000000000001111111100111111111111111111111111110000000000000000000000000000000000000000000000000000011111111111111101111111111111111000000000000000
0000000000001111111101111111111111111111111111110000000000000000000000000000000000000000000000000001010011111111111101111011111111110000000000000000
0000000000000111111101111111111111111111111111000000000000000000000000000000000000000000000010000011110000011111111110111101111111110000000000000000
0000000000001111111011111111100111111111100011000000000000000000000000000000000000000000000000000000000000011111111110011111111111111000000000000000
0000000000001111110011111111111111110101110011100000000000000000000000000000000000000000000000000000000001111100001111100011111111111000000000000000
0000000000001111101111111111111010111111111111110010000000000000000000000000000000000000000000000100100111111111111111100011111111111100000000000000
0000000000001111101111111111100000111100000010111111111100000000000000000000000000000000111111111111100001111111111111110011111111111000000000000000
0000000000001111101111111110000100111111111111111000111111100100000000000000011110000000000101100011111110011111111111110011111111111100000000000000
0000000000001111101111111000111111111111111111111111100011111110000000100111110011111111111111111001101111101111111111111011111111111100000000000000
0000000000011111111111111110111111111111111111111111111100100111100000111110000111111111111111100011001111110011100001001011111111111100000000000000
0000000000001111111011111100000111101110111111111111111111100111000000111000000001111100111100010110001111111000000000011011111111111110000000000000
0000000000001111100011111000110000111111101111111111111111110011000000111100000000111110000001000111000000101110000000000011111111111110000000000000
0000000000001111110011111000001111011111111111111111111111110011100000000011110111111111000110111111110110011110000000000111111111111111000000000000
0000011100011111100101110010010111111001111111011111111111100110000000011111011011111111101011111110111100011110000000000001111111111100000000000000
0000011001101111000111100011111000011000011110011100111001100111000000011111101001110110111111110111111111001111110000000001111111111110000000000000
0000111011010011100111111111111100000000000000001110000010000110000000001110111111000000001111111111111001100110000000000000111111110111000000110000
0000011011110101100111111110001111111111111111110011110000000111000000101111111110000011111111111111100010000011111100000001111111011111001111101000
0000101001001100100111110011111110001111110001111111100000111111000000011111001111111111111111110011001000001101000000000000011101111000111111111000
0000010000000000100111111111100000000011110111111110001111111110000000000111100000000111111000000000000000000001100000000000011111111111101111101000
0000001100000000110111111111111100000000000011111100011111111110000000000000000000000000111000000000000000000100000000000000100101011111100011000000
0000000101011001111111111111111001000000000000111110011111111100000000000000000000000000110000000000000000000000000000000000011011101111100000100000
0000000001100011001111110011110000000000000000011111000111110100000000000000000000000000000000000000000000000000000000000000001011111011100010000000
0000000000111100000101111111111100100000000000011110011111100000000000000000000000000000000000000000000000000000000001101110000000000010111100000000
0000000000011101110111110011111111110000000000011111111111110000000000000000000000110000000000000000000000000000000000001000000001100101110000000000
0000000000000110000110111101111111111111000111111110001111111110000000000000000000111111100000000000000000000000000000011000000010001010100000000000
0000000000000111110011111111111111111111111111011011111111111111100000000000000000011111111100000000000000000000000000110000000001111111000000000000
0000000000000011111011111111111111111111110000111001111111111110000000011111111111110011111111000000000000000000000000110000001100010110000000000000
0000000000000010011111111111111111111110010111111001111111111111111111011111000000110000110111110000000000000000000001111000001110011000000000000000
0000000000000000111111111111111111000010110000000000111111111110011101111111100011000000111001111011000110000000000001111000110000000000000000000000
0000000000000000110101111111111100111000001111111010110111111111111111110000011011000000000110001110001000100000000001111101010000000000000000000000
0000000000000000000000011111111100111000011111111111101111111111111111101010111110011011001111101111111001100000000111100100001110000000000000000000
0000000000000000000000011111111110111010011111111111101111011111111110001110000000010010111111110001111011000010000111111000000000000000000000000000
0000000000000000000000001111111111111010011111111111111111110110000000000000000011111111000111011000111100000000000111110000000000000000000000000000
0000000000000000000000000111110011111110011111110111111111100010100000111000000010000011110001110000011101000000001111100000000000000000000000000000
0000000000000000000000000001111101111111011110011111111111111111111111111111111111111111111001110000011010110000111110000000000000000000000000000000
0000000000000000000000000000111110111110001111000111000000110011111000000011110001100111111101000000011111000111111101000000000000000000000000000000
0000000000000000000000000000001111000100011111111000100011111100011000000001111111011100001011000000111110000111110111010000000000000000000000000000
0000000000000000000000000000000011110000111111111011101100001111110011111111111000000000001111100111111101111110001011000000000000000000000000000000
0000000000000000000000000000000000110100011111111111001111100111011111111111010000000000000111111111110011110000000111000100000000000000000000000000
0000000000000000000000000000000000011110001111111111111000001000000111111111000000000000000011011111011110000000001111100000011000000000000000000000
0000000000000000000000000000000000011111111111111111111111111111111111000000000000000000000001111111111000000000011111110000001110100000000000000000
0000000000000000000000000000000000111000111111111101111111100100000000000000000000000000000001111111000000000000010111111000000000000110000000000000
0000000000000000000000000000000001001000001111111100011111100000000000000000000000000000011111111000000000000001111111111100000000000000000000000000
0000000000000000000000000000000011001111111011111100000110000000000000000000000000000000011111000000000000000001111111111000000000000000000001100000
0000000000000000000000000000000011000111111110111110000000000000000000000000000000000001111100000000000000000011101111111000000000000000000000101111
0000000000000000000000000000000110000011111111110111111100000000000000000000000000000111000000000000000000001111111111110000000000000000000001011111
0000000000000000000000000000001110000001111111111111111111001000000000000000000001111100010000000100000000001111111111100000000000000000000000001111
0000000000000000000000000000001110000001111111111111111111111101111111111111111100000000000000000000000000111111111111100000000000000000000000000111
0000000000000000000000111110101110000000111111111111111111100001100000000000000000000001110000000000000000001111111111110000000000000000000000000011
0000000000000000001001111101001111000000011111111111111111111000010100000000000000011111000000110000000000011111111111110000000000000000000000000011
0000000000000100011011110001011111000000111111111111111111111111000000000000011111111001111111100000000000111111111111100000000000000000000000000001
0000000001000001111111000000011111000000111111111111111111111111000000000000011111111111111100100001100001111111111111000000000000000000000000000000
0000010000111001111111000000011111100000110111111111111111111111100000000100001110111111111100001000100000111111111111000000000000000000000000000000
0101111100111111111100000000111111110000111011111111111111111111111000000011101111111111000000001100011000111111111110000000000000000000000000000000
1111111111111111111010000000111111111000011111111111111111111111111000000000000000100000000000000000110011111111111110000000000000000000000000000000
1111111111111111110000100000111111111111111111111111111111111111110000000000000000000001100000000000000011111111111111000110000100010000000000000000
1111111111111111100110010000011111111111111111111111111111111111111100000000000000111000000001000000011111101111111110100110010100100110000000000000
1111111111111111110000000011111111111111111111111111111111111111110000000000000000001111111100000001111111011111011110001000000001100001001001010010
1111111111111111000110000000111111111111111111111111111111111111110000000000000000110111111100000000111111011111111100000000000000000000001111100004