0 RRRDLLLDRRR
1 RRRDLLLDRRR
2 RRRDLLLDRRR
3 RRRDLLLDRRR
4 RRRDLLLDRRR
5 RRRDLLLDRRR
6 RRRDLLLDRRR
7 RRRDLLLDRRR
8 RRRDLLLDRRR
9 RRRDLLLDRRR
10 RRRDLLLDRRR