1600 1200 28
3000000000000000000000000000000000000000000000000000000
0000000000000000000000001111111111111110000000000000000
0000000000000000000111111000000000000011111100000000000
0000000000000001111100000000000000000000000011100000000
0000000000000111000000000000000000000000000000011100000
0000000000111000000000000000000000000000000000000011000
0000000001100000000000000000000000000000000000000011100
0000000011000000000000000000000000000000000000000011000
0000000110000000000000000000000111000000000000001100000
0000001100000000000000000000001111100000000000110000000
0000011000000000000000000000011111110000000011000000000
0000110000000000000000000000001111100000001100000000000
0001100000000000000000000000000111000000110000000000000
0001000000000000000000000000000000000011000000000000000
0001000000000000000000000000000000001100000000000000000
0011000000000000000000000000000000110000000000000000000
0011000000000000000000000000000011000000000000000000000
0011000000000000000000000000000110000000000000000000000
0011000000000000000000000000000001100000000000000000000
0011000000000000000000000000000000110000000000000000000
0001000000000000000000000000000000001100000000000000000
0001100000000000000000000000000000000011000000000000000
0000110000000000000000000000000000000001100000000000000
0000011000000000000000000000000000000000011000000000000
0000001100000000000000000000000000000000000110000000000
0000000110000000000000000000000000000000000011000000000
0000000011000000000000000000000000000000000000110000000
0000000001100000000000000000000000000000000000001100000
0000000000011000000000000000000000000000000000000110000
0000000000000110000000000000000000000000000000001100000
0000000000000001110000000000000000000000000001110000000
0000000000000000001111000000000000000000111110000000000
0000000000000000000000111111111111111111100000000000000
0000000000000000000000000000000000000000000000000000004
